   ####
####  #
#  B  ##
# #B#  #
#  B   #
#.###  #
#.#### #
#. &   #
########