#################
#  #  #  #  #   #
#.B   #  #.B    #
#  #.B .B   #   #
# &#  #  #  #   #
#################