     ####
 #####  #
 # B B  #
 #.# #. #
 # B&B ##
##.# #.##
#  X X  #
#   #   #
#########