 #####
 #   #
 # #B##
## &  #
# .#B #
# .  ##
# .#B#
##   #
 #####