#### ####
#  ###  #
# B X B #
#   W   #
### .B###
  # . #
  #####