 #####
 #   #
 # # ##
## X  ##
# BXB  #
#  X # #
## .  W#
 #######