      ####
####### .#
# B B BB #
#   & ...#
###   ####
  #####